
arena hue:
0 255 255

layout:
1111111111111111111
1000000000000000001
1011121112111211101
2000000000000000002
1011111111111111101
1000000000000000001
1011011121211101101
1012010022200102101
1012010112110102101
1011010122210101101
1000000000000000001
1011010122210101101
1012010112110102101
1011010022200101101
1000011121211100001
1011022222222201101
1000000000000000001
1011111111111111101
2000000000000000002
1011121112111211101
1000000000000000001
1111111111111111111

bigFood:
(2.5, 4) (18.5, 4) (2.5, 17.5) (18.5, 17.5)

resting coordinates:
yellow = (10, 17)
red = (10, 11)
pink = (10, 11)
blue = (10, 11)
orange = (10, 11)

ghost area:
inside = (10, 11)
outside = (10, 9)

