arena hue:
0 121 53

layout:
1111111111111111111
2200000000000000022
1101011110111101011
2101000000000001012
1101011110111101011
1001000010100001001
1011111010101111101
1001100000000011001
1100001010101000011
2101011010101101012
2101001010101001012
1100011000001100011
1001000010100001001
1011111010101111101
1000010010100100001
1102000110110002011
2101110110110111012
2100010220220122012
1101010110110121011
2201110120210111022
1000000000000000001
1111111111111111111

bigFood:
(10.5, 2.5) (10.5, 19) (5.5, 10.5) (15.5, 10.5)

resting coordinates:
yellow = (10, 4)
red = (10, 19)
blue = (10, 19)
pink = (10, 19)
orange = (10, 19)
purple = (10, 19)

ghost area:
inside = (10, 21)
outside = (10, 19)
