
arena hue:
119 136 153

layout:
1111111111111111111
2000000000000000002
1101111110111111011
1000000000000000001
1011111110111111101
1010000000000000101
1010111110111110101
1010122210122210101
1010111210121110101
1000001110111000001
1011100000000011101
1000111010101110001
1110001010101000111
0000100000000010000
1110101010101010111
1100001010101000011
1001101010101011001
1011100010100011101
1011111000001111101
1000111112111110001
1110000022200000111
1111111111111111111

bigFood:
(10.5, 3.5) (6.5, 21.5) (14.5, 21.5)

resting coordinates:
yellow = (10, 11)
red = (10, 21)
blue = (10, 21)
pink = (10, 21)
orange = (10, 21)
purple = (10, 21)
green = (10, 21)
black = (10, 21)
silver = (10, 21)

ghost area:
inside = (10, 21)
outside = (10, 19)
